                                       
                                       
                                       
                                       
                                       
                          ########     
                           ########    
             ##                         
  ##     ~~~~~~~~~~~~~~~~~~               
        ~~~~~~~~~~~~~~~~~~~~~~   ##    
######                 ########  ##    
             ######    ##  ########    
             ######    ##  ########    
               ##  ####       ##       
             ##  ######       ##       
                     ##      ###       
                                       
################             
                                       
                       
                                       
                      
         ########  ##    ####          
             ##    ######    ######    
             ##    ######    ######    
             ##    ##          ######  
             ##    ##          ######  
             ########            ######
     ######      ######                
                        #  #       ####
                        #  #       ####
                                       
                                       
                                       
%%%%%%%%%%%%%%%%            %%%%%%%%   
                                       
   ######      %%%%%%%%%%   #######    
                                       
                                       
                                        