                                       
                                       
                                       
                                       
                                       
                          ########     
                            #####    
             ##                         
        ~~~~~~~~~~~~~~              
        ~~~~~~~~~~~~~~~~~~~~~~      
                       ########  ##    
             ######    ##  ########    
######       ######    ##  ########    
               ##  ####       ##       
             ##  ######       ##       
                     ##      ###       
                              ##         
################################              
                                       
                       
                                       
                      
         ########  ##    ####          
             ##    ######    ######    
             ##    ######    ######    
             ##    ##          ######  
             ##    ##          ######  
             ########            ######
     ######      ######                
                        #  #       ####
                        #  #       ####
                                       
                                       
%%%%%%                                        
%%%%%%%%%%                  %%%%%%%%   
                                       
   ######               
                                       
                                       
                                        