..........................
..........................
...@@@@@............@@@@@.
...@..@@............@@..@.
.@@@....@@..@@@@..@@.....@
.@......@@..@@@@..@@.....@
@@......@@@@@@@@@@@@.....@
@@......@@@@@@@@@@@@.....@
@@.....@@@@@@@@@@@@@@...@@
@@.....@@@@@@@@@@@@@@...@@
.@....@@@@@@@@@@@@@@@@@@@@
.@@@@@@@@@@@@@@@@@@@@@@@@@
..@@@@@@@@@@@@@@@@@@@@@@@.
..@@@@@@@@@@@@@@@@@@@@@@@.
....@@@@@@..@@..@@@@@@@...
....@@@@@@..@@..@@@@@@@...
....@@@@@@@@@@@@@@@@@@@...
....@@@@@@@@@@@@@@@@@@@...
@@@@@@@@@@@@@@@@@@@@@@@@@@
@@@@......@@@@........@@@@
@@@@@@@@@@@@@@@@@@@@@@@@@@
@@@@@@@@@@@@@@@@@@@@@@@@@@
....@@@@@@......@@@@@@@@..
....@@@@@@.@@@@.@@@@@@@@..
......@....@..@.....@.....
......@....@..@.....@.....