..........@@..@@..@@@@....
..........@@..@@..@@@@....
...@@@@@@@@@..@@..........
...@@@@@@@@@..@@..........
......@...@@..@@@@..@@@@@@
......@...@@..@@@@..@@@@@@
...@..........@@..@@@@@@@@
...@..........@@..@@@@@@@@
...@..@@@@@@@@@@@@@@@@@@@@
...@..@@@@@@@@@@@@@@@@..@@
..@@@@@@@@....@@..@@@@...@
........@@....@@..@@@@...@
.@@@@@@@..@@@@@@@@@@@@....
.@@@@@@@..@@@@@@@@@@@@....
......@@....@@@@@@@@@@@@..
......@@....@@@@@@@@@@@@..
@@@@..@@@@@@@@@@@@@@@@@@..
@@@@..@@@@@@@@@@@@@@@@@@..
.@@@@@@@@@@@@@........@@@.
.@@@@@@@@@@@@@........@@@.
..@@@@@@........@@@@@@@@..
..@@@@@@..........@@@@@@..
....@@@@..........@@...@..
....@@@@...@@@@...@@...@..
....@@@@...@..@...........
..@@@@@@...@..@...........