..............@@@@@@......
..............@@@@@@......
..@@@@@@..........@@......
..@@@@@@@@..@@....@@......
........@@..@@........@@@@
........@@............@@@@
..@@@@@@@@@@..@@@.....@@@@
..@@@@@@@@@@..@@@.....@@..
..........@@..@@..@@@.@@..
....@@@@@@@@..@@..@@@.@@..
@@..@@@@@@@@@@@@..@@@@@@..
@@..@@@@@@@@@@@@..@@@@@@..
........@@@@......@@@@....
........@@@@......@@......
@@@@@@..@@@@@@@@..@@......
@@@@@@..@@@@@@@@..@@......
..........@@@@@@..@@@@@@..
..........@@......@@@@@@..
@@@@@@....................
@@@@@@....................
....@@..@@@@......@@@@...@
....@@............@@@@...@
@@................@@....@@
@@.........@@@@...@@....@@
...........@..@...........
...........@..@...........