..........................
........@@......@@........
..@@@@@@@@......@@@@@@@@..
..@@@@@@@@......@@@@@@@@..
..@@........@@........@@..
..@@........@@........@@..
..@@..@@@@......@@@@..@@@@
..@@..@@..........@@..@@@@
..@@..@.@@..@@..@@.@..@@@@
..@@..@.@@@@@@@@@@.@..@@@@
..@@....@@@@@@@@@@....@@@@
........@@@@@@@@@@......@@
@@......@@@@@@@@@@......@@
@@@@....@@@@@@@@@@....@@@@
@@@@..@.@@@@@@@@@@.@..@@..
@@@@..@.@@..@@..@@.@..@@..
@@@@..@@..........@@..@@..
@@@@..@@@@......@@@@..@@..
@@@@........@@........@@..
@@@@........@@........@@..
@@@@@@@@@@......@@@@@@@@@@
@@@@@@@@@@......@@@@@@@@@@
@@@@....@@......@@....@@..
@@@@.......@@@@.......@@..
@@@@.......@..@...........
@@@@.......@..@...........