..........................
..........................
@@@@......@@@@@@......@@@@
@@@@....@@@@@@@@@@....@@@@
@@.....@@@@@@@@@@@@.....@@
@@.....@@@@@@@@@@@@.....@@
......@@@@@@@@@@@@@@......
......@@@@@@@@@@@@@@......
......@@@@@@@@@@@@@@......
......@@@@@@@@@@@@@@......
@@....@@@@@@@@@@@@@@....@@
@@....@@@@@@@@@@@@@@....@@
@@@@....@@@@@@@@@@....@@@@
@@@@....@@@@@@@@@@....@@@@
@@@@@@..@@@@@@@@@@..@@@@@@
@@@@@@..@@@@@@@@@@..@@@@@@
.........@.@.@.@.@........
.........@.@.@.@.@........
........@.@.@.@.@.........
........@.@.@.@.@.........
.@.@.@..............@.@.@.
.@.@.@..............@.@.@.
@.@.@................@.@.@
@.@.@......@@@@......@.@.@
@.@.@..@...@..@...@..@.@.@
@.@.@..@...@..@...@..@.@.@