........@@@@....@@........
........@@@@....@@........
..@@@@@@@@......@@........
..@@@@@@@@......@@........
@@@@@@@@@@@@@@@@@@@@......
@@@@@@@@@@@@@@@@@@@@......
@@@@@@@@@@@@@@@@@@@@@@@@@@
@@..@@@@@@@@@@@@@@@@@@@@@@
@@@@@@@@@@@@@@@@@@@@@.@@..
@@@@@@@@@@@@..@@@@@@@.@@..
..@@@@@@..@@@@@@@@@@..@@..
..@@@@@@@@@@@@@@@@@@..@@..
..@@@@@@@@@@@@@@@@@@@.@@@@
..@@@@@@@@@@@@@@@@@@@.@@@@
.@@@@@@@......@@@@......@@
.@..@@@@......@@........@@
..@@..@@......@@@@@@@@@.@@
..@@..@@....@@..@@@@@@@.@@
..@@......@@@@@@@@@@....@@
..@@.....@@@..@@@@@@....@@
..@@@@@..@@@@@@@..@@@@@@@@
..@@@@@..@@@@@@@@@@@@@@@@@
....@@...@......@@@@@@@@..
....@@..@@.@@@@.@@@@..@@..
....@@..@@.@..@...@@@@@@..
...........@..@...@@@@@@..