..........................
..........................
....@@@@@@................
....@@@@@@................
......@@..@@..............
......@@..@@@@............
..@@........@@............
..@@........@@@@..........
..@@@@....@@..@@..........
..@@@@....@@..@@@@........
..@@..@@..@@....@@........
..@@..@@..@@....@@@@......
..@@....@@......@@@@......
..@@....@@......@@@@@@....
....@@........@@@@@@@@....
....@@........@@@@@@@@@@..
......@@....@@..@@@@@@@@..
......@@....@@..@@@@@@@@..
@@..........@@....@@@@@@@@
@@..........@@....@@@@@@@@
@@@@..........@@..@@@@@@@@
@@@@..........@@..@@@@@@@@
@@@@@@..........@@..@@@@@@
@@@@@@.....@@@@.@@..@@@@@@
@@@@@@@@...@..@.@@....@@@@
@@@@@@@@...@..@.@@....@@@@