..........................
.......@@...........@@....
..@@..@@@.....------@@@@..
..@@..@@@.....------@@@@..
..@@....@@..@@----------..
..@@....@@..@@----------..
------@.@@....@@--------..
------@.@@....@@--------..
------------@@@@.@@.......
------------@@@@.@@.......
.....@--------@@.@@...@@@@
.....@--------@@.@@.......
@@@@@@@@--------------@@@@
@@@@@@@@--------------@@@@
......@@@@-------@........
......@@@@-------@........
..@@@@@@..------@@@@..@@..
..@@@@@@..------@@@@..@@..
------@@--........@@..@@..
------@@--........@@..@@..
----------@@..@@......@@..
----------..........@@@@..
@@--------........@@......
@@--------.@@@@...@@......
@@@@@......@..@...@@..@@..
@@@@@......@..@...@@..@@..