................@@@@@@@@..
................@@@@@@@@..
..@@............@@....@@..
..@@............@@....@@..
@@@@@@......@@@@@@@@..@@..
@@@@@@......@@@@@@@@..@@..
..@@@@@@....@@..@@@@@@@@..
..@@@@@@....@@..@@@@@@@@..
....@@..@@@@@@@@..@@......
....@@..@@@@@@@@..@@......
........@@..@@@@@@@@......
........@@..@@@@@@@@......
....@@@@@@@@..@@..........
....@@@@@@@@..@@..........
....@@..@@@@@@@@..........
....@@..@@@@@@@@..........
@@@@@@@@..@@....@@@@......
@@@@@@@@..@@....@@@@......
@@..@@@@@@@@....@@@@@@....
@@..@@@@@@@@....@@@@@@....
@@....@@..........@@@@@@..
@@....@@..........@@@@@@..
@@@@@@@@............@@@@@@
@@@@@@@@...@@@@.....@@@@@@
...........@..@.......@@@@
...........@..@.......@@@@