..@@..@@..@@..@@..@@..@@..
..@@..@@..@@..@@..@@..@@..
..@@..@@..@@..@@..@@..@@..
..@@..@@..@@..@@..@@..@@..
..@@..@@..@@..@@..@@..@@..
..........................
........@@......@@........
@@..@@..@@......@@..@@..@@
@@..@@@@@@..@@..@@@@@@..@@
@@..@@..@@..@@..@@..@@..@@
@@..@@..@@..@@..@@..@@..@@
........@@......@@........
@@@@....@@..@@..@@....@@@@
@@@@....@@..@@..@@....@@@@
@@@@@@@@@@@@@@@@@@@@@@@@@@
@@@@@@@@@@..@@..@@@@@@@@@@
@@@@@@@@@@@@@@@@@@@@@@@@@@
@@@@@@@@@@@@@@@@@@@@@@@@@@
........@@@@@@@@@@........
@@..@@..@@@@@@@@@@..@@..@@
..@@..@@....@@....@@..@@..
..@@..@@....@@....@@..@@..
..@@..@@..........@@..@@..
..@@..@@...@@@@...@@..@@..
..@@..@@...@..@...@@..@@..
...........@..@...........