.......................................
.......................................
.......................................
.......................................
.......................................
..........................########.....
...........................########....
.............##............##....##....
..##............##....##...............
...........######......########..##....
######.................########..##....
.............######....##..########....
.............######....##..########....
...............##..########..##........
@@@..........##..########..##......
.....................##..########......
.....................##..########......
.................########..##..........
.................########..##..........
.................##..########..........
.................##..########..........
....########..##....####...............
.........########..##....####..........
.............##..########....######....
.............##..########....######....
.............##....##..........######..
.............##....##..........######..
.............########............######
.....@@@@@@..########...####.....######
........................#..#.......####
........................#..#.......####
.......................................
.........~~~~~~~~~~~~~~~~~~~~..........
.......................................
%%%%%%%%%%%%%%%%............%%%%%%%%...
.......................................
...@@@@@@......%%%%%%%%%%...@@@@@@@....
.......................................
.......................................
.......................................
.......................................
.......................................
.......................................
.......................................
