
......@@..@@....@@..@@....
......@@..@@....@@..@@....
................@@..@@....
................@@..@@....
......@@....@@..@@..@@....
......@@..@@@@..@@..@@....
@@..@@@@..@@....@@..@@....
....@@@@..@@..@@....@@....
....@@@@......@@..........
....@@@@......@@..........
@@..@@@@@@..@@@@@@@@....@@
@@..@@@@@@..@@@@@@@@....@@
..............@@..@@..@@@@
......@@......@@..@@......
@@@@.@@@..@@@@@@@@@@......
@@@@.@@@..@@@@@@@@@@..@@@@
@@...@....@@@@@@@@@@..@@..
.....@....@@@@@@@@@@..@@..
..........@@..@@..@@..@@..
..@@......@@..@@..@@..@@..
..@@......@@@@@@....@@@@@@
..@@..@@............@@@@@@
..@@..@@..........@@@@@@@@
..@@..@@...@@@@...@@@@@@@@
...........@..@...@@..@@..
...........@..@...@@..@@..