..........................
......@@@@@@....@@........
....@@@@@@@@@@@@@@@@......
..@@@@@@@@@@@@@@@@@@......
..@@@@@@@@@@@@@@@@@@@@....
..@@@@@@@@@@@@@@@@@@@@....
@@@@............@@@@@@@@..
@@@@............@@@@@@@@..
@@..@@....@@......@@@@@@..
@@..@@....@@......@@@@@@..
@@..@@....@@......@@@@@@..
@@..@@....@@......@@@@@@..
@@....@@........@@@@@@@@@.
@@....@@........@@@@@@@@@.
@@@@@@@@@@@@@@@@@@@@@@@@@.
@@@@@@@@@@@@@@@@@@@@@@@@@.
@@@@@@@@@@@@@@@@@@@@@@@@..
@@@@@@@@@@@@@@@@@@@@@@@@..
..@@@@@@@@@@@@@@@@@@@@..@@
..@@@@@@@@@@@@@@@@@@@@..@@
@@..@@@@@@@@@@@@@@@@@...@@
@@..@@@@@@@@@@@@@@@@@...@@
..@@@@@@@@......@@@@@@@@@@
..@@@@..@@.@@@@.@@@@@@@@@@
...........@..@...........
...........@..@...........