..........@@..............
..........@@..............
........@@@@@@............
........@@@@@@............
....@@....@@....@@@@......
....@@....@@....@@@@......
..@@##@@......@@####@@....
..@@##@@......@@####@@....
....@@##@@......@@@@....@@
....@@##@@......@@@@....@@
@@....@@....@@........@@@@
@@....@@....@@........@@@@
##@@......@@@@@@....@@..@@
##@@......@@@@@@....@@..@@
@@##@@......@@....@@@@@@..
@@##@@......@@....@@@@@@..
##@@....@@......@@..@@....
##@@....@@......@@..@@....
@@....@@##@@..@@##@@......
@@....@@##@@..@@##@@......
......@@##@@....@@....@@..
......@@##@@....@@....@@..
..@@....@@..........@@@@@@
..@@....@@.####.....@@@@@@
@@@@@@.....#..#...@@##@@..
@@@@@@.....#..#...@@##@@..