..........................
..........................
..........@@@@............
..........@@@@............
............@@............
............@@............
..@@@@@@@@##@@##@@@@@@@@..
..@@@@@@@@##@@##@@@@@@@@..
......@@@@@@@@@@@@@@......
......@@@@@@@@@@@@@@......
@@......@@@@@@@@@@......@@
@@......@@@@@@@@@@......@@
@@@@......@@@@@@......@@@@
@@@@......@@@@@@......@@@@
@@........@@@@@@........@@
@@......@@..@@..@@......@@
........@@......@@........
........@@..@@..@@........
......@@....@@....@@......
......@@....@@....@@......
..........................
..........................
..........................
...........####...........
....@@.....#..#.....@@....
....@@.....#..#.....@@....