....@@..##@@.........#....
....@@..##...........#....
....##..##@@..########....
....##..##@@....######....
..@@@@..##@@.##.......@@@@
..@@@@..##@@.##.......@@@@
@@@@@@@@@@@@######...###..
@@@@@@@@@@@@######...###..
....@@@@....@@##...#####.#
....@@@@####..##...###...#
##@@....####......####...#
##....##..........##.....#
.#....##------------------
.#..####------------------
.#..##..------------------
.#......------------------
....@@..------------------
....@@..------------------
##..##..------------------
##..##..------------------
.#..##..------------------
.#..##..------------------
.#..##..........----------
.#..##.....####.----------
....##.....#..#...--------
...........#..#...--------