....~~~~..................
....~~~~..................
......~~@@..#.............
@@....~~@@..#.............
@@..........@...#...~~~~..
@@@@........@...#...~~~~..
@@@@..@@...#....@.@@~~....
@@@@....##.#....@.@@~~....
@@@@@@....@@...#..........
@@@@@@....@@##.#........@@
@@@@@@.....#..@@........@@
@@@@..@@...#..@@##....@@@@
@@@@....##@@...#..@@..@@@@
@@........@@...#......@@@@
..........#.##@@....@@@@@@
..........#...@@....@@@@@@
....~~@@.@....#.##..@@@@@@
....~~@@.@....#...@@..@@@@
..~~~~...#...@..........@@
..~~~~...#...@..........@@
.............#..@@~~....@@
.............#..@@~~......
@@................~~~~....
@@.........####...~~~~....
@@@@.......#..#.........@@
@@@@.......#..#.........@@