........@@................
........@@................
@@@@....@@....@@@@........
@@@@....@@....@@@@........
..@@....@@......@@..@@@@@@
..@@....@@......@@..@@@@@@
..@@....@@@@@@..@@..@@....
..@@....@@@@@@..@@..@@....
..@@........@@..@@@@@@....
..@@........@@..@@@@@@....
@@@@@@..@@@@@@@@@@........
@@@@@@..@@@@@@@@@@........
....@@@@@@@@....@@....@@@@
....@@@@@@@@....@@....@@@@
....@@....@@....@@....@@..
....@@....@@....@@....@@..
....@@....@@....@@@@@@@@..
....@@....@@....@@@@@@@@..
@@@@@@@@@@@@@@@@@@..@@@@..
@@@@@@@@@@@@@@@@@@..@@@@..
......@@........@@@@..@@..
......@@........@@@@..@@..
......@@..........@@..@@..
......@@...@@@@...@@..@@..
......@@...@..@...@@..@@..
......@@...@..@...@@..@@..