.....................@@...
.....................@@...
....................@@....
............@@......@@....
............@@....@@@.....
..........@@@@@@..@@@.....
..........@@@@@@..@@@.....
........@@@@@@@@@@@@@.....
........@@@@--@@@@@@@.....
......@@@@@@--@@@@@@@.....
......@@@@------@@@@@.....
....@@@@@@------@@@@@.....
....@@@@----------@@@@....
..@@@@@@----------@@@@@@..
..@@@@--------------@@@@..
@@@@@@--------------@@@@@@
@@@@------------------@@@@
@@@@------------------@@@@
..@@------------------@@..
..@@------------------@@..
..@@------------------@@..
..@@------------------@@..
..@@------......------@@..
..@@------.@@@@.------@@..
..@@----...@..@...----@@..
..@@----...@..@...----@@..