....................@@....
....................@@....
..@@@@@@..@@..@@..........
..@@@@@@..@@..@@..........
....@@@@@@@@@@@@@@@@..@@..
....@@@@@@@@@@@@@@@@..@@..
..........@@@@@@@@@@@@....
..........@@@@@@@@@@@@....
..@@....@@@@..@@..........
..@@....@@@@..@@..........
@@@@@@..@@@@@@........@@..
@@@@@@..@@@@@@........@@..
@@@@@@............@@....@@
@@@@@@............@@....@@
..@@@@@@..@@..............
..@@@@@@..@@..............
@@..@@@@@@@@@@@@@@@@..@@..
@@..@@@@@@@@@@@@@@@@..@@..
........@@..@@@@@@@@@@@@..
........@@..@@@@@@@@@@@@..
......@@@@......@@@@@@@@..
......@@@@......@@@@@@@@..
....@@..@@................
....@@..@@.@@@@...........
@@.........@..@...@@@@....
@@.........@..@...@@@@....