.......................................
.......................................
.......................................
.......................................
.......................................
...............######..................
...................##..................
...................##..................
...................##..................
... ...............##..................
.... ..............##..................
...%%...###################.....##.....
...%%...#########.....#####.....##.....
...%%...##......................##.....
%%%%%...##......................##.....
%%%%%...##......................##.....
........##.............................
........##.............................
........##.............................
........##%%%%%%%~~~~~~~~~~~~..........
.......................................
.......................................
.......................................
..............................%%%%%%%%%
..............................%%%%%%%%%
..............................%%.......
.........##################...%%.......
####################..........%%.......
.............      ########...%%.......
..............................%%.......
..............................%%.......
..............................%%.......
.~~~~~~~~~~~~~~...............%%.......
..............................%%.......
...........%%%%%%%%%%%%%%%%%%%%%.......
...........%%%%%%%%%%%%%%%%%%%%%.......
.......................................
.......................................
.......................................
.......................................
