.......................................
.......................................
.......................................
.......................................
.......................................
.......................................
...............@@@@@@...................
...................@@...................
...................@@..................
...................@@..................
...................@@..................
...................@@..................
........@@@@@@@@@.....@@@@@.....@@.....
........@@@@@@@@@.....@@@@@.....@@.....
........@@......................@@.....
........@@......................@@.....
........@@......................@@.....
........@@......................@@.....
........@@......................@@.....
........@@......................@@.....
........@@.......~~~~~~~~~~~~...@@.....
.................~~~~~~~~~~~~..........
.......................................
.......................................
.......................................
.......................................
.......................................
.......................................
.......................................
.......................................
.......................................
.......................................
.......................................
.......................................
.......................................
.......................................
.......................................
.......................................
.......................................
.......................................
