..........................
..........................
..........................
..........@@@@......@@....
..........@@@@......@@....
..@@@@..@@@@@@@@..@@@@@@..
..@@@@..@@@@@@@@..@@@@@@..
@@@@@@@@@@@@@@@@@@@@@@@@@@
@@@@@@@@@@@@@@@@@@@@@@@@@@
@@@@@@@@@@@@@@@@@@@@@@@@@@
@@@@@@@@@@@@@@@@@@@@@@@@@@
@@@@@@@@@@@@@@@@@@@@@@@@@@
@@@@@@@@@@@@@@@@@@@@@@@@@@
@@@@@@@@@@@@@@@@@@@@@@@@@@
@@@@@@@@@@@@@@@@@@@@@@@@@@
@@@@@@@@@@@@@@@@@@@@@@@@@@
@@@@@@@@@@@@@@@@@@@@@@@@@@
@@@@@@@@@@@@@@@@@@@@@@@@@@
@@@@@@@@@@@@@@@@@@@@@@@@@@
@@@@@@@@@@....@@@@@@@@@@..
@@@@@@@@@@....@@@@@@@@@@..
..@@@@@@........@@@@@@....
..@@@@@@........@@@@@@....
...........@@@@...........
...........@..@...........
...........@..@...........