......@@........@@........
......@@........@@........
@@@@..@@..@@@@@@@@..@@@@@@
@@@@..@@..@@@@@@@@..@@@@@@
@@@@@@....@@....@@..@@@@@@
@@@@@@....@@....@@..@@@@@@
@@@@@@@@@@..@@....@@@@@@@@
@@@@@@@@@@..@@....@@@@@@@@
@@@@..@@....@@..@@@@@@@@@@
@@@@..@@....@@..@@@@@@@@@@
@@@@..@@..@@@@....@@......
@@@@..@@..@@@@....@@......
....@@@@@@..@@@@..@@....@@
....@@@@@@..@@@@..@@....@@
..@@@@@@@@@@@@@@..@@@@..@@
..@@@@@@@@@@@@@@..@@@@..@@
@@....@@....@@..@@@@@@..@@
@@....@@....@@..@@@@@@..@@
@@@@..@@@@..@@@@@@@@@@....
@@@@..@@@@..@@@@@@@@@@....
....@@..@@@@....@@@@....@@
....@@..@@@@....@@@@....@@
..@@@@@@@@........@@..@@@@
..@@@@@@@@.@@@@...@@..@@@@
..@@.......@..@...........
..@@.......@..@...........