------------..------------
------------..------------
--------------------------
--------------------------
------@@----------@@------
------@@----------@@------
--@@..@@..@@--@@..@@..@@--
--@@..@@..@@--@@..@@..@@--
--@@@@@@..........@@@@@@--
--....@@..........@@------
------@@..@@@@@@..@@------
------@@@@@@@@@@@@@@------
@@------..@@..@@..------@@
@@------..........------@@
--------..........--------
--------..@@..@@..--------
--------..@@..@@..--------
--------..@@..@@..--------
------@@..........@@------
------@@....@@....@@------
--@@--@@..@@@@@@..@@--@@--
--@@--@@..........@@--@@--
..@@..@@..........@@..@@..
..@@@@@@...@@@@...@@@@@@..
..@@.......@..@.......@@..
...........@..@...........