........@@........@@......
........@@........@@......
..@@......@@....@@@@@@....
..@@......@@....@@@@@@....
....@@........@@@@..@.....
....@@........@@@@@@@.....
......@@..@@@@@@@@@@...@..
......@@..@@@@@@@@@@...@..
..@.....@@@@@@@@@@....@@..
..@.....@@@@@@@@@@....@@..
..@@@.@@..@@@@@@@@.....@..
....@.@@..@@@@@@@@.....@..
....@@@@@@@@@@....@@......
....@@@@@@@@@@....@@......
....@.@@..@@@@......@@....
..@@@.@@..@@@@......@@....
..@@@@@@@@..@@........@@..
..@@@@@@@@..@@..@@....@@..
@@@@@@@@.........@........
@@@@@@@@.........@........
....@@.................@@@
....@@.................@@@
....................@.....
...........@@@@...@@@.....
@..........@..@...........
@...@@.....@..@...........