........@..@..............
........@..@..............
@.@.@..@..@.....@.@.......
@.@.@..@..@.....@.@.......
@.@.@.@@@@......@.@@@.....
@.@.@.@@@@......@.@@@.....
.@.@..@@@......@@.@@@@....
.@.@..@@@......@@.@@@@....
..@...@@.@@...@.@@@@@@....
..@...@@.@@...@.@@@@@@....
..@..@....@@@.@@.@.@@@....
..@..@....@@@.@@.@.@@@....
..@......@@@@@@...@.@@....
..@......@@@@@@...@.@@....
...@....@.@@@@@...@.@@....
...@....@.@@@@@...@.@@....
...@@@@@..@@@@@@..@.@.@@@@
...@......@@@@@@..@.@...@@
...@.....@@.@@.@@.@.@..@.@
...@.....@@.@@.@@...@..@.@
....@...@@.@@.@@@@.....@..
....@...@@.@@.@@@@.....@..
....@..@@.......@@@...@...
....@..@@..@@@@.@@@...@...
....@..@...@..@...@@@@....
....@..@...@..@...@@@@....