
.......................................
.......................................
.......................................
............................###########
.......................................
.......................................
.......................................
.......................................
..............####.....................
.......................................
.......########................##......
.............................##......
.......................................
............##..........####...........
..........####............##...........
..........####............##...........
........######............##...........
........######............##...........
......########............##...........
......########............##...........
......####..................####.......
......####...................####......
........##......................##.....
........#############...........##.....
...............######...........##.....
...............######...........##.....
...............####...........####.....
....~~.........####..........####......
....~~.........##.............##.......
....~~.........##.............##.......
....~~............##..........##.......
....~~..........####.......#####.......
....~~.................................
....~~~~~~~~~~~~~~............	   ~~~~
.......................................
....%%%%%%%%%%%%%%.....................
....%%%%%%%%%%%%%%.....................
.......................................
.......................................
.......................................
