.......................................
.......................................
.......................................
.......................................
.......................................
.......................................
.......................................
.......................................
........@@@@@@@@@@........~~~~~~~~.....
.......................................
.......#########..........########.....
.......#####.................#####.....
.......#####...................###.....
.......###   .......       ....##.....
.......##    ........       ....#.....
%%%%%%%%%%%%%  ............  ....##....
%%%%%%%%%      ............  .. ###....
........      ............  ..####.....
......  ############. ....  ######.....
......  ############..... ########.....
...............#####. .................
...............##### ..................
.......%%%.....######........#####.....
.......%%%.....######..........#####...
.......%%%.....######..........#####...
...............######..........#####...
...............######.........    .....
...............####..........    ......
...............###............  .......
...............###............  .......
...............###  ..........  .......
...........%%%%%%%%%%%%%%%    %%%......
...........%%%%%%%%%%%%%  ... %%%......
.......................................
.......................................
.......................................
.......................................
.......................................
.......................................
.......................................
