
.......................................
.......................................
.......................................
.......................................
.......................................
.......................................
.......................................
.......................................
..............@@@@.....................
.......................................
.......@@@@@@@@................@@......
.......@@......................@@......
.......................................
............@@..........@@@@...........
..........@@@@............@@...........
..........@@@@............@@...........
........@@@@@@............@@...........
........@@@@@@............@@...........
......@@@@@@@@............@@...........
......@@@@@@@@............@@...........
......@@@@..................@@@@.......
......@@@@...................@@@@......
........@@......................@@.....
........@@.....@@@@@@...........@@.....
...............@@@@@@...........@@.....
...............@@@@@@...........@@.....
...............@@@@...........@@@@.....
...............@@@@..........@@@@......
...............@@.............@@.......
...............@@.............@@.......
..................@@..........@@.......
................@@@@.......@@@@@.......
.......................................
.......................................
.......................................
.......................................
.......................................
.......................................
.......................................
.......................................
