...........@..@.@@@@......
...........@..@.@@@@......
..@..@..@........@@@@..@@@
..@..@..@........@@@@..@@@
..@..@..@...@@...@@@@..@@@
..@..@..@...@@...@@@@..@@@
..@@....@@..@@..@@@@..@@@@
..@@....@@..@@..@@@@..@@@@
.......@@@..@@..@@@...@@@@
.......@....@@....@...@@@@
@@@@@.....@@@@@@.....@@@@@
@@@@@.....@@@@@@.....@@@@@
.........@@@@@@@@.........
.........@@@@@@@@.........
@@@@@@..@@@@@@@@@@.@@@@@@@
@@@@@@....@@@@@@...@@@@@@@
@@@@@@......@@......@@@@@@
........@@..@@..@@........
..@@....@@......@@........
..@@....@@......@@........
..@@@.....@@..@@.....@@@@@
..@@@................@@@@@
....@@..............@@@@@@
...........@@@@.....@@@@@@
...........@..@.......@@@@
....@@.....@..@.....@@@@@@