
.......................................
.......................................
.......................................
.......................................
.......................................
.......................................
..............####.....................
.......................................
..............................##...
.............................##....
.....................##......##....
.....................##....###.....
...................######..###.....
...................######..###.....
.................#############.....
.................####%%#######.....
...............######%%#######.....
...............####%%%%%%#####.....
.............######%%%%%%#####.....
.............####%%%%%%%%%%####....
...........######%%%%%%%%%%######..
...........####%%%%%%%%%%%%%%####..
.........######%%%%%%%%%%%%%%######
.........####%%%%...........%%%%####
.........####%%%%...........%%%####
...........##%%%%...........%%%##..
...........##%%%%...........%%%##..
...........##%%%%...........%%%##..
...........##%%%%...........%%%##..
...........##%%%%...........%%%##..
...........##%%%%...........%%%##..
...........##%%%%.......... %%%##..
.......    @@@@@@.......... %%%##..
..######  .........................
.......................................
.......................................
.......................................
.......................................
.......................................