
.......................................
.......................................
.......................................
.......................................
.......................................
.......................................
.......................................
.......................................
...........~~~~~~~~~~~~~~~~~...........
...............~~~~~~~~~~..............
.......................................
.......................................
.......................................
........%%%%%%.......@@@@@@@...........
........%%%%%%........@@....@@.........
........%%%%%%..............@@.........
.........%%%%%%............  @@.. .....
........%%%%%%............  .@@........
......%%%%%...............  .@@........
......%%%%............... ....@@.......
...###########..........############...
......###########.....##########.......
.............##############............
.......................................
.......................................
.........................@@@@@@@@@@....
.............................####......
..............................##.......
..............................##.......
..............................##.......
@@@@@@@@@@....................~........
............................. ~........
..............................~........
..............................~........
..............................~........
.........................~~~~~~........
.......................................
.......................................
.......................................

