
.......................................
.......................................
.......................................
.......................................
.......................................
.......................................
.......................................
.......................................
...........~~~~~~~~~~~~~~~~~...........
...............~~~~~~~~................
.......................................
.......................................
.......................................
........      .......       ...........
........      ........       ..........
........      ............  ...........
.........      ............  .. .......
........      ............  ...........
......  ..................  ...........
......  ................. .............
...#################################...
......##########################.....
.............##############..........
.......................................
.......................................
..............................    .....
.............................    ......
..............................  .......
..............................  .......
..............................  .......
@@@@@@@@@@..........          .........
............................. .........
.......................................
.......................................
.......................................
.......................................
.......................................
.......................................
.......................................

