....@@....@@......@@......
....@@....@@..@@..@@......
@@@@@@@@..@@......@@@.....
@@@@@@@@..@@..@@..@@@.....
@@@@@@....@@..@@..@@...@@.
@@@@@@........@@.......@@.
@@@@@@@@@@@@@@@@@@@@@@..@@
@@@@@@@@@@@@@@@@@@@@@@..@@
..@@......................
..@@........@@@@..........
....@@.....@@@@@@@@@@@@@@@
....@@.....@@@@@..@@......
@@@@..@@...@@@@@@@@@....@@
@@@@..@@...@@@@@@@@@@@@@@@
......@@......@@@@@@@@....
......@@..@@..@@@@@@@@....
@@@@..@@@@@@@@@@..@@@@@@@@
@@@@..@@@@@@@@@@..@@@@@@@@
@@@@...@..................
@@@@...@....@@@@..........
@@@@@@..@......@......@@..
@@@@@@..@......@..@@@@@@..
@@..@@..@.........@@..@@..
@@@@@@..@..@@@@.......@@..
...........@..@.......@@..
...........@..@...@@......