......@@............@@....
......@@..........@@@@....
@@............@@.@@@@...@@
@@..........@@@@.@@@@...@@
........@@.@@@@...@@@@....
......@@@@.@@@@.....@@....
.....@@@@...@@@@..........
.....@@@@.....@@..........
......@@@@................
........@@................
......@@..@@..@@..@@......
......@@@@@@..@@@@@@......
@@@@...@@@@....@@@@...@@@@
@@@@...@@@@....@@@@...@@@@
......@@@@@@..@@@@@@......
......@@..@@..@@..@@......
..........................
........@@......@@........
@@.....@@@@....@@@@.....@@
@@.....@@@@....@@@@.....@@
@@....@@@@@@..@@@@@@....@@
@@....@@..@@..@@..@@....@@
..........................
....@@.....@@@@.....@@....
....@@@@...@..@...@@@@....
....@@@@...@..@...@@@@....